이병헌|Lee Byung-hun|BH Entertainment
한효주|Han Hyo-joo|BH Entertainment
김고은|Kim Go-eun|BH Entertainment
박보영|Park Bo-young|BH Entertainment
한지민|Han Ji-min|BH Entertainment

공유|Gong Yoo|Management SOOP
공효진|Gong Hyo-jin|Management SOOP
배수지|Bae Suzy|Management SOOP
최우식|Choi Woo-shik|Management SOOP
정유미|Jung Yu-mi|Management SOOP
남주혁|Nam Joo-hyuk|Management SOOP

이정재|Lee Jung-jae|Artist Company
정우성|Jung Woo-sung|Artist Company
김윤석|Kim Yoon-seok|Artist Company

현빈|Hyun Bin|VAST Entertainment

손예진|Son Ye-jin|MSTEAM Entertainment
이민정|Lee Min-jung|MSTEAM Entertainment
위하준|Wi Ha-jun|MSTEAM Entertainment

신민아|Shin Min-a|AM Entertainment
김우빈|Kim Woo-bin|AM Entertainment

김수현|Kim Soo-hyun|GOLDMEDALIST

송중기|Song Joong-ki|HighZium Studio
김지원|Kim Ji-won|HighZium Studio

전지현|Jun Ji-hyun (Gianna Jun)|IEUM HASHTAG

송혜교|Song Hye-kyo|UAA (United Artist Agency)

박신혜|Park Shin-hye|SALT Entertainment
김선호|Kim Seon-ho|SALT Entertainment

박은빈|Park Eun-bin|Namoo Actors
문근영|Moon Geun-young|Namoo Actors

변요한|Byun Yo-han|Saram Entertainment
박규영|Park Gyu-young|Saram Entertainment

김태희|Kim Tae-hee|STORY J Company
서인국|Seo In-guk|STORY J Company

이제훈|Lee Je-hoon|COMPANY ON

류준열|Ryu Jun-yeol|C-JeS Studio

박보검|Park Bo-gum|THEBLACKLABEL